Exercise Name | Primary Muscles | Secondary Muscles | Equipment | Category
Dumbbell Bench Press with Neutral Grip | chest | shoulders,triceps | dumbbell | strength
Cable Rear Delt Fly | shoulders |  | cable | strength
Battling Ropes | shoulders | chest,forearms | other | strength
Cable Iron Cross | chest |  | cable | strength
Kettlebell Pirate Ships | shoulders | abdominals | kettlebells | strength
Standing Palms-Up Barbell Behind The Back Wrist Curl | forearms |  | barbell | strength
Rocky Pull-Ups/Pulldowns | lats | biceps,middle back,shoulders | other | strength
Rickshaw Carry | forearms | abdominals,calves,glutes,hamstrings,lower back,quadriceps,traps | other | strongman
Vertical Swing | hamstrings | glutes,quadriceps,shoulders | dumbbell | plyometrics
Floor Press | triceps | chest,shoulders | barbell | powerlifting
Barbell Rollout from Bench | abdominals | glutes,hamstrings,lats,shoulders | barbell | strength
EZ-Bar Curl | biceps |  | e-z curl bar | strength
Return Push from Stance | shoulders | chest,triceps | medicine ball | plyometrics
Superman | lower back | glutes,hamstrings | body only | stretching
Cable Seated Crunch | abdominals |  | cable | strength
Kettlebell Turkish Get-Up (Squat style) | shoulders | abdominals,calves,hamstrings,quadriceps,triceps | kettlebells | strength
Palms-Up Dumbbell Wrist Curl Over A Bench | forearms |  | dumbbell | strength
Kneeling Squat | glutes | abdominals,hamstrings,lower back | barbell | powerlifting
Bodyweight Mid Row | middle back | biceps,lats | other | strength
Exercise Ball Pull-In | abdominals |  | exercise ball | strength
Incline Cable Flye | chest | shoulders | cable | strength
Flexor Incline Dumbbell Curls | biceps |  | dumbbell | strength
Deficit Deadlift | lower back | forearms,glutes,hamstrings,middle back,quadriceps,traps | barbell | powerlifting
Clean Shrug | traps | forearms,shoulders | barbell | olympic weightlifting
Car Drivers | shoulders | forearms | barbell | strength
Alternating Hang Clean | hamstrings | biceps,calves,forearms,glutes,lower back,traps | kettlebells | strength
Medicine Ball Chest Pass | chest | shoulders,triceps | medicine ball | plyometrics
Single Leg Push-off | quadriceps | calves,hamstrings | other | plyometrics
One-Arm Kettlebell Push Press | shoulders | calves,quadriceps,triceps | kettlebells | strength
Smith Machine Overhead Shoulder Press | shoulders | triceps | machine | strength
Decline Dumbbell Flyes | chest |  | dumbbell | strength
Backward Drag | quadriceps | calves,forearms,glutes,hamstrings,lower back | other | strongman
Dips - Chest Version | chest | shoulders,triceps | other | strength
Chair Lower Back Stretch | lats | lower back | None | stretching
Tricep Side Stretch | triceps | shoulders | None | stretching
Chin-Up | lats | biceps,forearms,middle back | body only | strength
Lying Prone Quadriceps | quadriceps |  | body only | stretching
Seated One-Arm Dumbbell Palms-Up Wrist Curl | forearms |  | dumbbell | strength
Alternating Renegade Row | middle back | abdominals,biceps,chest,lats,triceps | kettlebells | strength
Recumbent Bike | quadriceps | calves,glutes,hamstrings | machine | cardio
Suspended Fallout | abdominals | chest,lower back,shoulders | other | strength
Forward Drag with Press | chest | calves,glutes,hamstrings,quadriceps,shoulders,triceps | other | strongman
Seated Barbell Twist | abdominals |  | barbell | strength
Standing Calf Raises | calves |  | machine | strength
Barbell Side Split Squat | quadriceps | calves,hamstrings,lower back | barbell | strength
Upward Stretch | shoulders | chest,lats | None | stretching
One-Arm Side Deadlift | quadriceps | abdominals,calves,glutes,hamstrings,lower back,traps | barbell | strength
V-Bar Pullup | lats | biceps,middle back,shoulders | body only | strength
Cuban Press | shoulders | traps | dumbbell | strength
Hyperextensions (Back Extensions) | lower back | glutes,hamstrings | other | strength
Round The World Shoulder Stretch | shoulders | biceps,chest | other | stretching
Reverse Plate Curls | biceps | forearms | other | strength
Split Jump | quadriceps | calves,glutes,hamstrings | body only | plyometrics
Double Kettlebell Push Press | shoulders | calves,quadriceps,triceps | kettlebells | strength
Hang Snatch - Below Knees | hamstrings | abdominals,calves,forearms,glutes,lower back,quadriceps,shoulders,traps | barbell | olympic weightlifting
Standing Overhead Barbell Triceps Extension | triceps | shoulders | barbell | strength
T-Bar Row with Handle | middle back | biceps,lats | barbell | strength
Barbell Incline Shoulder Raise | shoulders | chest | barbell | strength
Standing Long Jump | quadriceps | calves,glutes,hamstrings | body only | plyometrics
Suspended Row | middle back | biceps,lats | other | strength
Single-Leg Stride Jump | quadriceps | abductors,adductors,calves,hamstrings | other | plyometrics
Reverse Flyes | shoulders |  | dumbbell | strength
Kettlebell Sumo High Pull | traps | adductors,glutes,hamstrings,quadriceps,shoulders | kettlebells | strength
One Arm Lat Pulldown | lats | biceps,middle back | cable | strength
Stomach Vacuum | abdominals |  | body only | stretching
Hang Snatch | hamstrings | abdominals,calves,forearms,glutes,lower back,quadriceps,shoulders,traps | barbell | olympic weightlifting
Hamstring-SMR | hamstrings |  | foam roll | stretching
Supine Chest Throw | triceps | chest,shoulders | medicine ball | plyometrics
Clean and Press | shoulders | abdominals,calves,glutes,hamstrings,lower back,middle back,quadriceps,shoulders,traps,triceps | barbell | strength
Straight-Arm Dumbbell Pullover | chest | lats,shoulders,triceps | dumbbell | strength
Speed Squats | quadriceps | calves,glutes,hamstrings,lower back | barbell | strength
Bench Sprint | quadriceps | calves,glutes,hamstrings | other | plyometrics
Prone Manual Hamstring | hamstrings |  | None | strength
Middle Back Stretch | middle back | abdominals,lats,lower back | None | stretching
High Cable Curls | biceps |  | cable | strength
Overhead Slam | lats |  | medicine ball | plyometrics
Ab Crunch Machine | abdominals |  | machine | strength
Barbell Incline Bench Press - Medium Grip | chest | shoulders,triceps | barbell | strength
IT Band and Glute Stretch | abductors |  | other | stretching
Seated One-Arm Dumbbell Palms-Down Wrist Curl | forearms |  | dumbbell | strength
Barbell Side Bend | abdominals | lower back | barbell | strength
Plyo Push-up | chest | shoulders,triceps | body only | plyometrics
Spider Curl | biceps |  | e-z curl bar | strength
Standing Low-Pulley One-Arm Triceps Extension | triceps | chest,shoulders | cable | strength
Band Pull Apart | shoulders | middle back,traps | bands | strength
Goblet Squat | quadriceps | calves,glutes,hamstrings,shoulders | kettlebells | strength
Physioball Hip Bridge | glutes | hamstrings | exercise ball | strength
Kneeling Arm Drill | shoulders | abdominals | None | plyometrics
Dip Machine | triceps | chest,shoulders | machine | strength
Weighted Sissy Squat | quadriceps | calves,glutes,hamstrings | barbell | strength
Speed Band Overhead Triceps | triceps |  | bands | strength
Upper Back Stretch | middle back | middle back | None | stretching
Sled Overhead Backward Walk | shoulders | calves,middle back,quadriceps | other | strength
On-Your-Back Quad Stretch | quadriceps |  | other | stretching
External Rotation with Band | shoulders |  | bands | strength
Car Deadlift | quadriceps | forearms,glutes,hamstrings,lower back,traps | other | strongman
Bent Press | abdominals | glutes,hamstrings,lower back,quadriceps,shoulders,triceps | kettlebells | strength
Seated Bent-Over One-Arm Dumbbell Triceps Extension | triceps |  | dumbbell | strength
Front Squats With Two Kettlebells | quadriceps | calves,glutes | kettlebells | strength
Dumbbell Squat To A Bench | quadriceps | calves,glutes,hamstrings,lower back | dumbbell | strength
Sandbag Load | quadriceps | abdominals,biceps,calves,forearms,glutes,hamstrings,lower back,middle back,shoulders,traps | other | strongman
Reverse Band Bench Press | triceps | chest,forearms,lats,middle back,shoulders | barbell | powerlifting
One-Arm Kettlebell Snatch | shoulders | calves,glutes,hamstrings,lower back,traps,triceps | kettlebells | strength
Preacher Hammer Dumbbell Curl | biceps | forearms | dumbbell | strength
Brachialis-SMR | biceps |  | foam roll | stretching
One Knee To Chest | glutes | hamstrings,lower back | None | stretching
Standing Cable Wood Chop | abdominals | shoulders | cable | strength
Rack Delivery | shoulders | forearms,traps | barbell | olympic weightlifting
Shoulder Stretch | shoulders |  | None | stretching
Incline Push-Up Close-Grip | triceps | chest,shoulders | body only | strength
Supine Two-Arm Overhead Throw | abdominals | chest,lats,shoulders | medicine ball | plyometrics
Cross-Body Crunch | abdominals |  | body only | strength
Otis-Up | abdominals | chest,shoulders,triceps | other | strength
Cable One Arm Tricep Extension | triceps |  | cable | strength
Piriformis-SMR | glutes |  | foam roll | stretching
Front Cable Raise | shoulders |  | cable | strength
Knee/Hip Raise On Parallel Bars | abdominals |  | other | strength
Iron Crosses (stretch) | quadriceps |  | None | stretching
Full Range-Of-Motion Lat Pulldown | lats | biceps,middle back,shoulders | cable | strength
One-Arm High-Pulley Cable Side Bends | abdominals |  | cable | strength
Smith Machine Leg Press | quadriceps | calves,glutes,hamstrings | machine | strength
Single-Leg Lateral Hop | quadriceps | abductors,adductors,calves,hamstrings | other | plyometrics
Straight-Arm Pulldown | lats |  | cable | strength
Kneeling Cable Crunch With Alternating Oblique Twists | abdominals |  | cable | strength
Pallof Press | abdominals | chest,shoulders,triceps | cable | strength
Around The Worlds | chest | shoulders | dumbbell | strength
Palms-Up Barbell Wrist Curl Over A Bench | forearms |  | barbell | strength
Lateral Box Jump | adductors | abductors,calves,glutes,hamstrings,quadriceps | other | plyometrics
Triceps Overhead Extension with Rope | triceps |  | cable | strength
Knee Across The Body | glutes | abductors,lower back | None | stretching
Stiff-Legged Dumbbell Deadlift | hamstrings | glutes,lower back | dumbbell | strength
Rope Crunch | abdominals |  | cable | strength
Oblique Crunches - On The Floor | abdominals |  | body only | strength
Dumbbell Raise | shoulders | biceps | dumbbell | strength
Machine Preacher Curls | biceps |  | machine | strength
Kettlebell Pass Between The Legs | abdominals | glutes,hamstrings,shoulders | kettlebells | strength
Plate Pinch | forearms |  | other | strength
Dumbbell Side Bend | abdominals |  | dumbbell | strength
Side Leg Raises | adductors |  | body only | stretching
Weighted Jump Squat | quadriceps | calves,glutes,hamstrings,lower back | barbell | strength
One-Arm Kettlebell Military Press To The Side | shoulders | triceps | kettlebells | strength
Sled Push | quadriceps | calves,chest,glutes,hamstrings,triceps | other | strongman
Chest Stretch on Stability Ball | chest |  | exercise ball | stretching
Quick Leap | quadriceps | calves,hamstrings | other | plyometrics
Smith Machine Pistol Squat | quadriceps | calves,glutes,hamstrings | machine | strength
Barbell Shoulder Press | shoulders | chest,triceps | barbell | strength
Reverse Band Power Squat | quadriceps | adductors,calves,glutes,hamstrings,lower back | barbell | powerlifting
Lower Back Curl | abdominals |  | body only | stretching
Frog Hops | quadriceps | calves,glutes,hamstrings | None | stretching
Rope Straight-Arm Pulldown | lats |  | cable | strength
Squat with Chains | quadriceps | adductors,calves,glutes,hamstrings,lower back | barbell | powerlifting
Keg Load | lower back | abdominals,biceps,calves,forearms,glutes,hamstrings,middle back,quadriceps,shoulders,traps | other | strongman
Reverse Machine Flyes | shoulders |  | machine | strength
Double Kettlebell Snatch | shoulders | glutes,hamstrings,quadriceps | kettlebells | strength
Drag Curl | biceps | forearms | barbell | strength
Thigh Adductor | adductors | glutes,hamstrings | machine | strength
Cable Seated Lateral Raise | shoulders | middle back,traps | cable | strength
EZ-Bar Skullcrusher | triceps | forearms | e-z curl bar | strength
Tuck Crunch | abdominals |  | body only | strength
One-Arm Kettlebell Row | middle back | biceps,lats | kettlebells | strength
Romanian Deadlift from Deficit | hamstrings | forearms,glutes,lower back,traps | barbell | olympic weightlifting
Barbell Shrug Behind The Back | traps | forearms,middle back | barbell | strength
Single Leg Butt Kick | quadriceps | calves,hamstrings | body only | plyometrics
Ball Leg Curl | hamstrings | calves,glutes | exercise ball | strength
Standing Toe Touches | hamstrings | calves | None | stretching
Muscle Snatch | hamstrings | glutes,lower back,quadriceps,shoulders,triceps | barbell | olympic weightlifting
Incline Inner Biceps Curl | biceps |  | dumbbell | strength
Triceps Stretch | triceps | lats | None | stretching
Log Lift | shoulders | abdominals,chest,glutes,hamstrings,lower back,middle back,quadriceps,traps,triceps | other | strongman
Tricep Dumbbell Kickback | triceps |  | dumbbell | strength
Chest Push from 3 point stance | chest | abdominals,shoulders,triceps | medicine ball | plyometrics
One Leg Barbell Squat | quadriceps | calves,glutes,hamstrings | barbell | strength
Weighted Ball Side Bend | abdominals |  | exercise ball | strength
Iron Cross | shoulders | chest,glutes,hamstrings,lower back,quadriceps,traps | dumbbell | strength
Lying Glute | glutes | abductors | body only | stretching
Sumo Deadlift with Bands | hamstrings | adductors,forearms,glutes,lower back,middle back,quadriceps,traps | barbell | powerlifting
Janda Sit-Up | abdominals |  | body only | strength
Muscle Up | lats | abdominals,biceps,forearms,middle back,shoulders,traps,triceps | other | strength
Sumo Deadlift with Chains | hamstrings | abductors,adductors,forearms,glutes,lower back,middle back,quadriceps,traps | barbell | powerlifting
Elliptical Trainer | quadriceps | calves,glutes,hamstrings | machine | cardio
Ankle Circles | calves |  | None | stretching
Leg Press | quadriceps | calves,glutes,hamstrings | machine | strength
Dumbbell Prone Incline Curl | biceps |  | dumbbell | strength
Barbell Ab Rollout | abdominals | lower back,shoulders | barbell | strength
Underhand Cable Pulldowns | lats | biceps,middle back,shoulders | cable | strength
Upright Row - With Bands | traps | shoulders | bands | strength
Alternating Kettlebell Row | middle back | biceps,lats | kettlebells | strength
One-Arm Kettlebell Split Snatch | shoulders | hamstrings,quadriceps | kettlebells | strength
Rope Jumping | quadriceps | calves,hamstrings | other | cardio
Seated Bent-Over Rear Delt Raise | shoulders |  | dumbbell | strength
One Handed Hang | lats | biceps | other | stretching
Decline Smith Press | chest | shoulders,triceps | machine | strength
Reverse Cable Curl | biceps | forearms | cable | strength
Drop Push | chest | shoulders,triceps | other | plyometrics
Cat Stretch | lower back | middle back,traps | None | stretching
Dumbbell Floor Press | triceps | chest,shoulders | dumbbell | powerlifting
Smith Machine Close-Grip Bench Press | triceps | chest,shoulders | machine | strength
Push Press | shoulders | quadriceps,triceps | barbell | olympic weightlifting
Chair Leg Extended Stretch | hamstrings | adductors | other | stretching
Box Squat | quadriceps | adductors,calves,glutes,hamstrings,lower back | barbell | powerlifting
Catch and Overhead Throw | lats | abdominals,chest,shoulders | medicine ball | plyometrics
Dumbbell Seated One-Leg Calf Raise | calves |  | dumbbell | strength
Spider Crawl | abdominals | chest,shoulders,triceps | body only | strength
Chair Upper Body Stretch | shoulders | biceps,chest | other | stretching
Incline Barbell Triceps Extension | triceps | forearms | barbell | strength
Olympic Squat | quadriceps | calves,glutes,hamstrings | barbell | olympic weightlifting
Board Press | triceps | chest,forearms,lats,shoulders | barbell | powerlifting
Sledgehammer Swings | abdominals | calves,forearms,lats,middle back,shoulders | other | plyometrics
Kneeling High Pulley Row | lats | biceps,middle back | cable | strength
Single Leg Glute Bridge | glutes | hamstrings | body only | strength
Latissimus Dorsi-SMR | lats |  | foam roll | stretching
Power Partials | shoulders |  | dumbbell | strength
Weighted Pull Ups | lats | biceps,middle back | other | strength
Toe Touchers | abdominals |  | body only | stretching
Push Up to Side Plank | chest | abdominals,shoulders,triceps | body only | strength
Standing Dumbbell Triceps Extension | triceps |  | dumbbell | strength
Elbows Back | chest | shoulders | None | stretching
Clean and Jerk | shoulders | abdominals,glutes,hamstrings,lower back,quadriceps,traps,triceps | barbell | olympic weightlifting
Band Assisted Pull-Up | lats | abdominals,forearms,middle back | other | strength
Seated Floor Hamstring Stretch | hamstrings | calves | None | stretching
Incline Cable Chest Press | chest | shoulders,triceps | cable | strength
Alternate Leg Diagonal Bound | quadriceps | abductors,adductors,calves,glutes,hamstrings | None | plyometrics
Monster Walk | abductors |  | bands | strength
Kettlebell Dead Clean | hamstrings | calves,glutes,lower back,quadriceps,traps | kettlebells | strength
Leverage Chest Press | chest | shoulders,triceps | machine | strength
Alternate Incline Dumbbell Curl | biceps | forearms | dumbbell | strength
Front Dumbbell Raise | shoulders |  | dumbbell | strength
Atlas Stones | lower back | abdominals,adductors,biceps,calves,forearms,glutes,hamstrings,middle back,quadriceps,traps | other | strongman
Bottoms Up | abdominals |  | body only | strength
Barbell Shrug | traps |  | barbell | strength
Upright Barbell Row | shoulders | traps | barbell | strength
Wrist Roller | forearms | shoulders | other | strength
Finger Curls | forearms |  | barbell | strength
Calf Press | calves |  | machine | strength
Calf Press On The Leg Press Machine | calves |  | machine | strength
Shoulder Circles | shoulders | traps | None | stretching
Cable Shrugs | traps |  | cable | strength
Upright Cable Row | traps | shoulders | cable | strength
Russian Twist | abdominals | lower back | body only | strength
Sit-Up | abdominals |  | body only | strength
Shoulder Press - With Bands | shoulders | triceps | bands | strength
Wide-Grip Lat Pulldown | lats | biceps,middle back,shoulders | cable | strength
Double Kettlebell Jerk | shoulders | calves,quadriceps,triceps | kettlebells | strength
Standing Dumbbell Reverse Curl | biceps | forearms | dumbbell | strength
Two-Arm Kettlebell Jerk | shoulders | calves,quadriceps,triceps | kettlebells | strength
Decline EZ Bar Triceps Extension | triceps |  | barbell | strength
Smith Single-Leg Split Squat | quadriceps | calves,glutes,hamstrings | machine | strength
Lying Face Down Plate Neck Resistance | neck |  | other | strength
Knee Circles | calves | hamstrings,quadriceps | body only | stretching
Glute Ham Raise | hamstrings | calves,glutes | machine | powerlifting
Rowing, Stationary | quadriceps | biceps,calves,glutes,hamstrings,lower back,middle back | machine | cardio
Standing Hip Flexors | quadriceps |  | None | stretching
Standing Barbell Calf Raise | calves |  | barbell | strength
Kettlebell One-Legged Deadlift | hamstrings | glutes,lower back | kettlebells | strength
Alternating Cable Shoulder Press | shoulders | triceps | cable | strength
Kettlebell Windmill | abdominals | glutes,hamstrings,shoulders,triceps | kettlebells | strength
Rack Pulls | lower back | forearms,glutes,hamstrings,traps | barbell | powerlifting
Suspended Reverse Crunch | abdominals |  | other | strength
Scissors Jump | quadriceps | glutes,hamstrings | body only | plyometrics
Peroneals-SMR | calves |  | foam roll | stretching
Alternating Deltoid Raise | shoulders |  | dumbbell | strength
Hammer Grip Incline DB Bench Press | chest | shoulders,triceps | dumbbell | strength
Overhead Triceps | triceps | lats | body only | stretching
Hug Knees To Chest | lower back | glutes | None | stretching
Leverage Decline Chest Press | chest | shoulders,triceps | machine | strength
Dumbbell One-Arm Triceps Extension | triceps |  | dumbbell | strength
Barbell Walking Lunge | quadriceps | calves,glutes,hamstrings | barbell | strength
Press Sit-Up | abdominals | chest,shoulders,triceps | barbell | strength
Walking, Treadmill | quadriceps | calves,glutes,hamstrings | machine | cardio
Standing Olympic Plate Hand Squeeze | forearms | biceps | other | strength
Weighted Ball Hyperextension | lower back | glutes,hamstrings,middle back | exercise ball | strength
Side Neck Stretch | neck |  | None | stretching
Ankle On The Knee | glutes |  | None | stretching
On Your Side Quad Stretch | quadriceps |  | None | stretching
Decline Push-Up | chest | shoulders,triceps | None | strength
Deadlift with Chains | lower back | forearms,glutes,hamstrings,middle back,quadriceps,traps | barbell | powerlifting
Pull Through | glutes | hamstrings,lower back | cable | strength
Sled Drag - Harness | quadriceps | calves,glutes,hamstrings | other | strongman
Flat Bench Lying Leg Raise | abdominals |  | body only | strength
Triceps Pushdown | triceps |  | cable | strength
Natural Glute Ham Raise | hamstrings | calves,glutes,lower back | body only | strength
Sumo Deadlift | hamstrings | adductors,forearms,glutes,lower back,middle back,quadriceps,traps | barbell | powerlifting
Kettlebell Seated Press | shoulders | triceps | kettlebells | strength
Narrow Stance Leg Press | quadriceps | calves,glutes,hamstrings | machine | strength
One-Arm Open Palm Kettlebell Clean | hamstrings | forearms,glutes,lower back,quadriceps,shoulders | kettlebells | strength
Leg-Up Hamstring Stretch | hamstrings |  | None | stretching
Preacher Curl | biceps |  | barbell | strength
Smith Incline Shoulder Raise | shoulders | chest | barbell | strength
Butt-Ups | abdominals |  | body only | strength
Rack Pull with Bands | lower back | forearms,glutes,hamstrings,quadriceps,traps | barbell | powerlifting
Wrist Rotations with Straight Bar | forearms |  | barbell | strength
Wrist Circles | forearms |  | body only | stretching
Zottman Curl | biceps | forearms | dumbbell | strength
Alternating Floor Press | chest | abdominals,shoulders,triceps | kettlebells | strength
Single-Leg Leg Extension | quadriceps |  | machine | strength
Leverage Shoulder Press | shoulders | triceps | machine | strength
Push-Ups With Feet On An Exercise Ball | chest | shoulders,triceps | exercise ball | strength
Dancer's Stretch | lower back | abductors,glutes | None | stretching
Split Squat with Dumbbells | quadriceps | glutes,hamstrings | dumbbell | strength
Lying Triceps Press | triceps |  | e-z curl bar | strength
Cable Internal Rotation | shoulders |  | cable | strength
Seated Good Mornings | lower back | glutes | barbell | powerlifting
Bench Dips | triceps | chest,shoulders | body only | strength
Standing Barbell Press Behind Neck | shoulders | triceps | barbell | strength
Smith Machine Bent Over Row | middle back | biceps,lats,shoulders | machine | strength
Palms-Down Wrist Curl Over A Bench | forearms |  | barbell | strength
Hyperextensions With No Hyperextension Bench | lower back | glutes,hamstrings | body only | strength
Reverse Triceps Bench Press | triceps | chest,shoulders | barbell | strength
Close-Grip EZ Bar Curl | biceps | forearms | barbell | strength
Iliotibial Tract-SMR | abductors |  | foam roll | stretching
Smith Machine Reverse Calf Raises | calves |  | machine | strength
Seated Triceps Press | triceps |  | dumbbell | strength
Mixed Grip Chin | middle back | biceps,lats | other | strength
Leg Lift | glutes | hamstrings | body only | strength
Peroneals Stretch | calves |  | other | stretching
Single-Cone Sprint Drill | quadriceps | calves,glutes,hamstrings | other | plyometrics
Lying Close-Grip Bar Curl On High Pulley | biceps |  | cable | strength
Standing Elevated Quad Stretch | quadriceps |  | other | stretching
Balance Board | calves | hamstrings,quadriceps | other | strength
Isometric Wipers | chest | abdominals,shoulders,triceps | body only | strength
Reverse Barbell Preacher Curls | biceps | forearms | e-z curl bar | strength
Dumbbell Lying Pronation | forearms |  | dumbbell | strength
Cable Rope Overhead Triceps Extension | triceps |  | cable | strength
Glute Kickback | glutes | hamstrings | body only | strength
Weighted Squat | quadriceps | calves,glutes,hamstrings | other | strength
Split Squats | hamstrings | calves,glutes,quadriceps | None | stretching
Crunches | abdominals |  | body only | strength
One Arm Chin-Up | middle back | biceps,forearms,lats | other | strength
Weighted Sit-Ups - With Bands | abdominals |  | other | strength
Smith Machine Bench Press | chest | shoulders,triceps | machine | strength
Single Dumbbell Raise | shoulders | forearms,traps | dumbbell | strength
Bent Over Two-Dumbbell Row With Palms In | middle back | biceps,lats | dumbbell | strength
Barbell Bench Press - Medium Grip | chest | shoulders,triceps | barbell | strength
One-Arm Medicine Ball Slam | abdominals | lats,shoulders | medicine ball | strength
Frog Sit-Ups | abdominals |  | body only | strength
One Arm Floor Press | triceps | chest,shoulders | barbell | strength
Tire Flip | quadriceps | calves,chest,forearms,glutes,hamstrings,lower back,shoulders,traps,triceps | other | strongman
Decline Barbell Bench Press | chest | shoulders,triceps | barbell | strength
Axle Deadlift | lower back | forearms,glutes,hamstrings,middle back,quadriceps,traps | other | strongman
Standing Dumbbell Press | shoulders | triceps | dumbbell | strength
Incline Hammer Curls | biceps |  | dumbbell | strength
Push-Up Wide | chest | abdominals,shoulders,triceps | body only | strength
Reverse Band Box Squat | quadriceps | abductors,adductors,calves,forearms,glutes,hamstrings,lower back | barbell | powerlifting
Barbell Lunge | quadriceps | calves,glutes,hamstrings | barbell | strength
Looking At Ceiling | quadriceps |  | None | stretching
Bench Jump | quadriceps | calves,glutes,hamstrings | body only | plyometrics
Speed Box Squat | quadriceps | calves,glutes,hamstrings | barbell | powerlifting
Seated Dumbbell Press | shoulders | triceps | dumbbell | strength
Dumbbell Shoulder Press | shoulders | triceps | dumbbell | strength
Decline Dumbbell Triceps Extension | triceps |  | dumbbell | strength
Box Squat with Bands | quadriceps | abductors,adductors,calves,glutes,hamstrings,lower back | barbell | powerlifting
Hanging Bar Good Morning | hamstrings | abdominals,glutes,lower back | barbell | powerlifting
Side Lying Groin Stretch | adductors | hamstrings | None | stretching
Clock Push-Up | chest | shoulders,triceps | body only | strength
Wide-Grip Standing Barbell Curl | biceps |  | barbell | strength
Side Laterals to Front Raise | shoulders | traps | dumbbell | strength
Dumbbell One-Arm Shoulder Press | shoulders | triceps | dumbbell | strength
Seated One-arm Cable Pulley Rows | middle back | biceps,lats,traps | cable | strength
Lateral Cone Hops | adductors | abductors,calves,glutes,hamstrings,quadriceps | other | plyometrics
Standing Gastrocnemius Calf Stretch | calves | hamstrings | None | stretching
Bent Over Dumbbell Rear Delt Raise With Head On Bench | shoulders |  | dumbbell | strength
Romanian Deadlift | hamstrings | calves,glutes,lower back | barbell | strength
Narrow Stance Hack Squats | quadriceps | calves,glutes,hamstrings | machine | strength
Standing Bent-Over One-Arm Dumbbell Triceps Extension | triceps | shoulders | dumbbell | strength
Shoulder Raise | shoulders | lats | None | stretching
Wide Stance Barbell Squat | quadriceps | calves,glutes,hamstrings,lower back | barbell | strength
Isometric Chest Squeezes | chest | shoulders,triceps | body only | plyometrics
Reverse Barbell Curl | biceps | forearms | barbell | strength
Standing Two-Arm Overhead Throw | shoulders | chest,lats | medicine ball | plyometrics
Sled Row | middle back | biceps,lats | other | strength
Mountain Climbers | quadriceps | chest,hamstrings,shoulders | None | plyometrics
Two-Arm Kettlebell Military Press | shoulders | triceps | kettlebells | strength
Incline Push-Up Medium | chest | abdominals,shoulders,triceps | body only | strength
One-Arm Kettlebell Floor Press | chest | triceps | kettlebells | strength
Lying Face Up Plate Neck Resistance | neck |  | other | strength
Band Hip Adductions | adductors |  | bands | strength
Two-Arm Dumbbell Preacher Curl | biceps |  | dumbbell | strength
Pushups | chest | shoulders,triceps | body only | strength
Adductor | adductors |  | foam roll | stretching
Double Kettlebell Alternating Hang Clean | hamstrings | biceps,calves,forearms,glutes,lower back,quadriceps,traps | kettlebells | strength
Weighted Crunches | abdominals |  | medicine ball | strength
Seated Dumbbell Inner Biceps Curl | biceps |  | dumbbell | strength
Bear Crawl Sled Drags | quadriceps | calves,glutes,hamstrings | other | strongman
Inverted Row with Straps | middle back | biceps,lats | other | strength
Standing Lateral Stretch | abdominals |  | None | stretching
Decline Reverse Crunch | abdominals |  | body only | strength
Single-Arm Cable Crossover | chest |  | cable | strength
One-Arm Kettlebell Para Press | shoulders | triceps | kettlebells | strength
Triceps Pushdown - Rope Attachment | triceps |  | cable | strength
Barbell Deadlift | lower back | calves,forearms,glutes,hamstrings,lats,middle back,quadriceps,traps | barbell | strength
Leverage Iso Row | lats | biceps,middle back | machine | strength
Carioca Quick Step | adductors | abdominals,abductors,calves,glutes,hamstrings,quadriceps | None | plyometrics
Shotgun Row | lats | biceps,middle back | cable | strength
Lateral Bound | adductors | abductors,calves,glutes,hamstrings,quadriceps | body only | plyometrics
Lower Back-SMR | lower back |  | foam roll | stretching
Snatch | quadriceps | biceps,glutes,hamstrings,lower back,shoulders,traps,triceps | barbell | olympic weightlifting
Jefferson Squats | quadriceps | calves,glutes,hamstrings,lower back,traps | barbell | strength
Dead Bug | abdominals |  | body only | strength
Dumbbell Shrug | traps |  | dumbbell | strength
Intermediate Groin Stretch | hamstrings |  | other | stretching
Crunch - Legs On Exercise Ball | abdominals |  | body only | strength
Standing Leg Curl | hamstrings |  | machine | strength
Seated Calf Raise | calves |  | machine | strength
Stairmaster | quadriceps | calves,glutes,hamstrings | machine | cardio
Star Jump | quadriceps | calves,glutes,hamstrings,shoulders | body only | plyometrics
Chin To Chest Stretch | neck | traps | None | stretching
Close-Grip EZ-Bar Press | triceps | chest,shoulders | e-z curl bar | strength
Kneeling Cable Triceps Extension | triceps |  | cable | strength
Seated Hamstring and Calf Stretch | hamstrings | calves | other | stretching
Step Mill | quadriceps | calves,glutes,hamstrings | machine | cardio
Straight Bar Bench Mid Rows | middle back | biceps,lats | barbell | strength
Smith Machine Behind the Back Shrug | traps | shoulders | machine | strength
Standing Alternating Dumbbell Press | shoulders | triceps | dumbbell | strength
Low Cable Crossover | chest | shoulders | cable | strength
V-Bar Pulldown | lats | biceps,middle back,shoulders | cable | strength
Atlas Stone Trainer | lower back | biceps,forearms,glutes,hamstrings,quadriceps | other | strongman
Smith Machine Squat | quadriceps | calves,glutes,hamstrings,lower back | machine | strength
Side To Side Chins | lats | biceps,forearms,middle back,shoulders | other | strength
Torso Rotation | abdominals |  | exercise ball | stretching
Hammer Curls | biceps |  | dumbbell | strength
Standing One-Arm Cable Curl | biceps |  | cable | strength
Cable Deadlifts | quadriceps | forearms,glutes,hamstrings,lower back | cable | strength
Incline Push-Up Wide | chest | abdominals,shoulders,triceps | body only | strength
Dumbbell Lying Supination | forearms |  | dumbbell | strength
Hang Clean - Below the Knees | quadriceps | calves,forearms,glutes,hamstrings,lower back,shoulders,traps | barbell | olympic weightlifting
Suspended Push-Up | chest | shoulders,triceps | other | strength
Plate Twist | abdominals |  | other | strength
Parallel Bar Dip | triceps | chest,shoulders | other | strength
Kettlebell Turkish Get-Up (Lunge style) | shoulders | abdominals,hamstrings,quadriceps,triceps | kettlebells | strength
Seated Side Lateral Raise | shoulders |  | dumbbell | strength
Machine Shoulder (Military) Press | shoulders | triceps | machine | strength
Neck-SMR | neck |  | other | stretching
Platform Hamstring Slides | hamstrings | glutes | other | strength
Narrow Stance Squats | quadriceps | calves,glutes,hamstrings,lower back | barbell | strength
Floor Press with Chains | triceps | chest,shoulders | barbell | powerlifting
Good Morning off Pins | hamstrings | abdominals,glutes,lower back | barbell | powerlifting
Adductor/Groin | adductors |  | None | stretching
Gorilla Chin/Crunch | abdominals | biceps,lats | body only | strength
Jogging, Treadmill | quadriceps | glutes,hamstrings | machine | cardio
Lying Bent Leg Groin | adductors |  | other | stretching
Heavy Bag Thrust | chest | abdominals,shoulders,triceps | other | plyometrics
Standing Bradford Press | shoulders | triceps | barbell | strength
Dumbbell Rear Lunge | quadriceps | calves,glutes,hamstrings | dumbbell | strength
Neck Press | chest | shoulders,triceps | barbell | strength
Pullups | lats | biceps,middle back | body only | strength
Barbell Squat | quadriceps | calves,glutes,hamstrings,lower back | barbell | strength
Power Snatch | hamstrings | calves,glutes,lower back,quadriceps,shoulders,traps,triceps | barbell | olympic weightlifting
Decline Dumbbell Bench Press | chest | shoulders,triceps | dumbbell | strength
Bodyweight Flyes | chest | abdominals,shoulders,triceps | e-z curl bar | strength
Exercise Ball Crunch | abdominals |  | exercise ball | strength
Medicine Ball Full Twist | abdominals | shoulders | medicine ball | plyometrics
Close-Grip Barbell Bench Press | triceps | chest,shoulders | barbell | strength
Split Jerk | quadriceps | glutes,hamstrings,shoulders,triceps | barbell | olympic weightlifting
Bent Over Low-Pulley Side Lateral | shoulders | lower back,middle back,traps | cable | strength
JM Press | triceps | chest,shoulders | barbell | strength
Linear Depth Jump | quadriceps | calves,glutes,hamstrings | other | plyometrics
Bosu Ball Cable Crunch With Side Bends | abdominals |  | cable | strength
Standing Cable Lift | abdominals | shoulders | cable | strength
Smith Machine Stiff-Legged Deadlift | hamstrings | glutes,lower back | machine | strength
Hanging Pike | abdominals |  | body only | strength
Chest Push with Run Release | chest | abdominals,shoulders,triceps | medicine ball | plyometrics
Dumbbell Bicep Curl | biceps | forearms | dumbbell | strength
Push-Ups - Close Triceps Position | triceps | chest,shoulders | body only | strength
Intermediate Hip Flexor and Quad Stretch | quadriceps |  | other | stretching
Lying Hamstring | hamstrings | calves | other | stretching
Kettlebell Arnold Press | shoulders | triceps | kettlebells | strength
Lying Cambered Barbell Row | middle back | biceps,lats,traps | barbell | strength
Double Leg Butt Kick | quadriceps | abductors,adductors,calves,glutes,hamstrings | body only | plyometrics
Standing Towel Triceps Extension | triceps |  | body only | strength
Side Standing Long Jump | quadriceps | calves,glutes,hamstrings | None | plyometrics
Power Snatch from Blocks | quadriceps | calves,forearms,glutes,hamstrings,lower back,shoulders,traps,triceps | barbell | olympic weightlifting
Landmine Linear Jammer | shoulders | abdominals,calves,chest,hamstrings,quadriceps,triceps | barbell | strength
Standing Biceps Stretch | biceps | chest,shoulders | other | stretching
Hamstring Stretch | hamstrings |  | None | stretching
Cable Incline Pushdown | lats |  | cable | strength
Barbell Rear Delt Row | shoulders | biceps,lats,middle back | barbell | strength
One Arm Supinated Dumbbell Triceps Extension | triceps |  | dumbbell | strength
Squat with Bands | quadriceps | adductors,calves,glutes,hamstrings,lower back | barbell | powerlifting
Seated Palm-Up Barbell Wrist Curl | forearms |  | barbell | strength
Dumbbell Lying Rear Lateral Raise | shoulders |  | dumbbell | strength
Chest Push (multiple response) | chest | abdominals,shoulders,triceps | medicine ball | plyometrics
Windmills | abductors | glutes,hamstrings,lower back | None | stretching
Stiff Leg Barbell Good Morning | lower back | glutes,hamstrings | barbell | strength
Reverse Band Sumo Deadlift | hamstrings | abductors,adductors,calves,forearms,glutes,lower back,quadriceps,traps | barbell | powerlifting
Side Lateral Raise | shoulders |  | dumbbell | strength
Deadlift with Bands | lower back | forearms,glutes,hamstrings,middle back,quadriceps,traps | barbell | powerlifting
One-Arm Flat Bench Dumbbell Flye | chest |  | dumbbell | strength
Double Kettlebell Windmill | abdominals | glutes,hamstrings,shoulders,triceps | kettlebells | strength
Side Bridge | abdominals | shoulders | body only | strength
Reverse Crunch | abdominals |  | body only | strength
Downward Facing Balance | glutes | abdominals,hamstrings | exercise ball | strength
Knee Tuck Jump | hamstrings | abductors,adductors,calves,glutes,quadriceps | body only | plyometrics
Tate Press | triceps | chest,shoulders | dumbbell | strength
Close-Grip Standing Barbell Curl | biceps | forearms | barbell | strength
Bench Press with Chains | triceps | chest,lats,shoulders | barbell | powerlifting
Smith Machine One-Arm Upright Row | shoulders | biceps,traps | machine | strength
One-Arm Side Laterals | shoulders |  | dumbbell | strength
Jackknife Sit-Up | abdominals |  | body only | strength
Rear Leg Raises | quadriceps |  | body only | stretching
Calves-SMR | calves |  | foam roll | stretching
Kettlebell Figure 8 | abdominals | hamstrings,shoulders | kettlebells | strength
One Half Locust | quadriceps | abdominals,biceps,chest | None | stretching
Incline Dumbbell Bench With Palms Facing In | chest | shoulders,triceps | dumbbell | strength
Front Box Jump | hamstrings | abductors,adductors,calves,glutes,quadriceps | other | plyometrics
Cable Crunch | abdominals |  | cable | strength
Lunge Sprint | quadriceps | calves,glutes,hamstrings | machine | strength
Handstand Push-Ups | shoulders | triceps | body only | strength
Kettlebell Hang Clean | hamstrings | calves,glutes,lower back,shoulders,traps | kettlebells | strength
Isometric Neck Exercise - Sides | neck |  | body only | strength
Power Stairs | hamstrings | adductors,calves,glutes,lower back,quadriceps,shoulders,traps | other | strongman
Cable Incline Triceps Extension | triceps |  | cable | strength
Linear 3-Part Start Technique | hamstrings | calves,quadriceps | None | plyometrics
Chest And Front Of Shoulder Stretch | chest | shoulders | other | stretching
Seated Head Harness Neck Resistance | neck |  | other | strength
Box Squat with Chains | quadriceps | abductors,adductors,calves,glutes,hamstrings,lower back | barbell | strength
Seated Overhead Stretch | abdominals |  | None | stretching
Depth Jump Leap | quadriceps | abductors,adductors,calves,glutes,hamstrings | other | plyometrics
Fast Skipping | quadriceps | abductors,adductors,calves,glutes,hamstrings | body only | plyometrics
Hip Extension with Bands | glutes | hamstrings | bands | strength
Calf Stretch Hands Against Wall | calves |  | None | stretching
Leverage Deadlift | quadriceps | glutes,hamstrings | machine | strength
Leverage Shrug | traps | forearms | machine | strength
Heaving Snatch Balance | quadriceps | abdominals,forearms,glutes,hamstrings,shoulders,triceps | barbell | olympic weightlifting
Hang Clean | quadriceps | calves,forearms,glutes,hamstrings,lower back,shoulders,traps | barbell | olympic weightlifting
Reverse Grip Triceps Pushdown | triceps |  | cable | strength
Hip Circles (prone) | abductors | adductors | body only | stretching
Wide-Grip Barbell Bench Press | chest | shoulders,triceps | barbell | strength
Kneeling Hip Flexor | quadriceps | quadriceps | None | stretching
Standing Bent-Over Two-Arm Dumbbell Triceps Extension | triceps |  | dumbbell | strength
Incline Dumbbell Flyes - With A Twist | chest | shoulders | dumbbell | strength
Groiners | adductors |  | body only | stretching
Seated Leg Curl | hamstrings |  | machine | strength
Dynamic Chest Stretch | chest | middle back | None | stretching
Overhead Squat | quadriceps | abdominals,calves,glutes,hamstrings,lower back,shoulders,triceps | barbell | olympic weightlifting
Lying High Bench Barbell Curl | biceps |  | barbell | strength
Band Good Morning | hamstrings | glutes,lower back | bands | powerlifting
Lying T-Bar Row | middle back | biceps,lats | machine | strength
Kneeling Single-Arm High Pulley Row | lats | biceps,middle back | cable | strength
Smith Machine Incline Bench Press | chest | shoulders,triceps | machine | strength
Svend Press | chest | forearms,shoulders,triceps | other | strength
Floor Glute-Ham Raise | hamstrings | calves,glutes | None | strength
Snatch Shrug | traps | forearms,shoulders | barbell | olympic weightlifting
Lying Leg Curls | hamstrings |  | machine | strength
Power Clean from Blocks | hamstrings | quadriceps | barbell | olympic weightlifting
Front Cone Hops (or hurdle hops) | quadriceps | abductors,adductors,calves,glutes,hamstrings | other | plyometrics
Weighted Bench Dip | triceps | chest,shoulders | other | strength
Barbell Ab Rollout - On Knees | abdominals | lower back,shoulders | barbell | strength
All Fours Quad Stretch | quadriceps | quadriceps | body only | stretching
Lying Dumbbell Tricep Extension | triceps | chest,shoulders | dumbbell | strength
Single-Arm Linear Jammer | shoulders | chest,triceps | barbell | strength
Front Barbell Squat To A Bench | quadriceps | calves,glutes,hamstrings | barbell | strength
Zercher Squats | quadriceps | calves,glutes,hamstrings | barbell | strength
One-Legged Cable Kickback | glutes | hamstrings | cable | strength
Circus Bell | shoulders | forearms,glutes,hamstrings,lower back,traps,triceps | other | strongman
Seated Dumbbell Palms-Up Wrist Curl | forearms |  | dumbbell | strength
Internal Rotation with Band | shoulders |  | bands | strength
Seated Band Hamstring Curl | hamstrings |  | other | strength
Smith Machine Hip Raise | abdominals |  | machine | strength
Cable Judo Flip | abdominals |  | cable | strength
Barbell Full Squat | quadriceps | calves,glutes,hamstrings,lower back | barbell | strength
Standing Dumbbell Straight-Arm Front Delt Raise Above Head | shoulders |  | dumbbell | strength
Gironda Sternum Chins | lats | biceps,middle back | other | strength
Rickshaw Deadlift | quadriceps | forearms,glutes,hamstrings,lower back,traps | other | strongman
One Arm Dumbbell Bench Press | chest | shoulders,triceps | dumbbell | strength
Farmer's Walk | forearms | abdominals,glutes,hamstrings,lower back,quadriceps,traps | other | strongman
Seated Glute | glutes | adductors | body only | stretching
Dips - Triceps Version | triceps | chest,shoulders | body only | strength
One-Arm Kettlebell Clean and Jerk | shoulders |  | kettlebells | strength
Alternate Heel Touchers | abdominals |  | body only | strength
Chest Push (single response) | chest | abdominals,shoulders,triceps | medicine ball | plyometrics
Decline Oblique Crunch | abdominals |  | body only | strength
Inchworm | hamstrings |  | body only | stretching
Lying Supine Dumbbell Curl | biceps |  | dumbbell | strength
Cable Shoulder Press | shoulders | triceps | cable | strength
Running, Treadmill | quadriceps | calves,glutes,hamstrings | machine | cardio
Wind Sprints | abdominals |  | body only | strength
External Rotation | shoulders |  | dumbbell | strength
Elbow Circles | shoulders | traps | None | stretching
Clean Deadlift | hamstrings | forearms,glutes,lower back,middle back,quadriceps,traps | barbell | olympic weightlifting
Close-Grip Push-Up off of a Dumbbell | triceps | abdominals,chest,shoulders | body only | strength
Cable Hip Adduction | quadriceps |  | cable | strength
Dumbbell Lying One-Arm Rear Lateral Raise | shoulders | middle back | dumbbell | strength
Pin Presses | triceps | chest,forearms,lats,middle back,shoulders | barbell | powerlifting
Frankenstein Squat | quadriceps | abdominals,calves,glutes,hamstrings | barbell | olympic weightlifting
Zottman Preacher Curl | biceps | forearms | dumbbell | strength
Dumbbell Step Ups | quadriceps | calves,glutes,hamstrings | dumbbell | strength
Body Tricep Press | triceps |  | body only | strength
Plie Dumbbell Squat | quadriceps | abdominals,calves,glutes,hamstrings | dumbbell | strength
Standing Rope Crunch | abdominals |  | cable | strength
Hip Flexion with Band | quadriceps |  | bands | strength
Reverse Band Deadlift | lower back | abductors,adductors,calves,glutes,hamstrings,quadriceps | barbell | powerlifting
Conan's Wheel | quadriceps | abdominals,biceps,calves,forearms,lower back,shoulders,traps | other | strongman
Bent Over Two-Dumbbell Row | middle back | biceps,lats,shoulders | dumbbell | strength
One-Arm Kettlebell Swings | hamstrings | calves,glutes,lower back,shoulders | kettlebells | strength
Pallof Press With Rotation | abdominals | chest,shoulders,triceps | cable | strength
Standing Front Barbell Raise Over Head | shoulders |  | barbell | strength
One-Arm Kettlebell Split Jerk | shoulders | glutes,hamstrings,quadriceps,triceps | kettlebells | strength
Overhead Stretch | abdominals | chest,forearms,lats,triceps | None | stretching
Lying Crossover | abductors |  | body only | stretching
Cable Reverse Crunch | abdominals |  | cable | strength
Calf-Machine Shoulder Shrug | traps |  | machine | strength
Oblique Crunches | abdominals |  | body only | strength
Seated Two-Arm Palms-Up Low-Pulley Wrist Curl | forearms |  | cable | strength
Overhead Cable Curl | biceps |  | cable | strength
Two-Arm Kettlebell Clean | shoulders | calves,glutes,hamstrings,lower back,traps | kettlebells | strength
Rocking Standing Calf Raise | calves |  | barbell | strength
Front Plate Raise | shoulders |  | other | strength
Quadriceps-SMR | quadriceps |  | foam roll | stretching
Dumbbell Squat | quadriceps | calves,glutes,hamstrings,lower back | dumbbell | strength
Low Cable Triceps Extension | triceps |  | cable | strength
Standing One-Arm Dumbbell Curl Over Incline Bench | biceps |  | dumbbell | strength
Snatch Balance | quadriceps | calves,glutes,hamstrings,shoulders,triceps | barbell | olympic weightlifting
Concentration Curls | biceps | forearms | dumbbell | strength
Standing Soleus And Achilles Stretch | calves |  | None | stretching
Cable Crossover | chest | shoulders | cable | strength
Barbell Hack Squat | quadriceps | calves,forearms,hamstrings | barbell | strength
Front Leg Raises | hamstrings |  | body only | stretching
Spinal Stretch | middle back | lats,lower back,neck,traps | None | stretching
Front Two-Dumbbell Raise | shoulders |  | dumbbell | strength
Band Skull Crusher | triceps |  | bands | strength
Pushups (Close and Wide Hand Positions) | chest | shoulders,triceps | body only | strength
Cable Preacher Curl | biceps | forearms | cable | strength
Cable Russian Twists | abdominals |  | cable | strength
Leg Pull-In | abdominals |  | body only | strength
Kettlebell Thruster | shoulders | quadriceps,triceps | kettlebells | strength
External Rotation with Cable | shoulders |  | cable | strength
Power Jerk | quadriceps | abdominals,calves,glutes,hamstrings,shoulders,triceps | barbell | olympic weightlifting
Upper Back-Leg Grab | hamstrings | lower back,middle back | None | stretching
Dumbbell Bench Press | chest | shoulders,triceps | dumbbell | strength
Calf Raise On A Dumbbell | calves |  | dumbbell | strength
Crunch - Hands Overhead | abdominals |  | body only | strength
Lunge Pass Through | hamstrings | calves,glutes,quadriceps | kettlebells | strength
Single-Leg Hop Progression | quadriceps | abductors,adductors,calves,hamstrings | other | plyometrics
Lying Rear Delt Raise | shoulders |  | dumbbell | strength
Cross Over - With Bands | chest | biceps,shoulders | bands | strength
Push-Ups With Feet Elevated | chest | shoulders,triceps | body only | strength
Dumbbell One-Arm Upright Row | shoulders | biceps,traps | dumbbell | strength
Seated Cable Rows | middle back | biceps,lats,shoulders | cable | strength
Kettlebell Pistol Squat | quadriceps | calves,glutes,hamstrings,shoulders | kettlebells | strength
Rope Climb | lats | biceps,forearms,middle back,shoulders | other | strength
Backward Medicine Ball Throw | shoulders |  | medicine ball | plyometrics
Donkey Calf Raises | calves |  | other | strength
Posterior Tibialis Stretch | calves |  | other | stretching
Snatch Deadlift | hamstrings | forearms,glutes,hamstrings,lower back,quadriceps,traps | barbell | olympic weightlifting
Lateral Raise - With Bands | shoulders |  | bands | strength
Standing Palm-In One-Arm Dumbbell Press | shoulders | triceps | dumbbell | strength
Bent-Knee Hip Raise | abdominals |  | body only | strength
Spell Caster | abdominals | glutes,shoulders | dumbbell | strength
Seated Biceps | biceps | chest,shoulders | body only | stretching
Seated Leg Tucks | abdominals |  | body only | strength
One-Arm Long Bar Row | middle back | biceps,lats | barbell | strength
Bicycling, Stationary | quadriceps | calves,glutes,hamstrings | machine | cardio
Kneeling Forearm Stretch | forearms |  | None | stretching
London Bridges | lats | biceps,forearms,middle back | other | strength
Standing Palms-In Dumbbell Press | shoulders | triceps | dumbbell | strength
Stiff-Legged Barbell Deadlift | hamstrings | glutes,lower back | barbell | strength
Squats - With Bands | quadriceps | calves,glutes,hamstrings,lower back | bands | strength
Front Squat (Clean Grip) | quadriceps | abdominals,glutes,hamstrings | barbell | strength
Anti-Gravity Press | shoulders | middle back,traps,triceps | barbell | strength
Flat Bench Cable Flyes | chest |  | cable | strength
Single-Leg High Box Squat | quadriceps | glutes,hamstrings | other | strength
One Arm Pronated Dumbbell Triceps Extension | triceps |  | dumbbell | strength
One-Arm Kettlebell Jerk | shoulders | calves,quadriceps,triceps | kettlebells | strength
Wide-Grip Pulldown Behind The Neck | lats | biceps,middle back,shoulders | cable | strength
Leverage High Row | middle back | lats | machine | strength
Plank | abdominals |  | body only | strength
Front Barbell Squat | quadriceps | calves,glutes,hamstrings | barbell | strength
Snatch from Blocks | quadriceps | calves,forearms,glutes,hamstrings,lower back,shoulders,traps,triceps | barbell | olympic weightlifting
Smith Machine Calf Raise | calves |  | machine | strength
Stride Jump Crossover | quadriceps | abductors,adductors,calves,hamstrings | other | plyometrics
Cable Rope Rear-Delt Rows | shoulders | biceps,middle back | cable | strength
Supine One-Arm Overhead Throw | abdominals | chest,lats,shoulders | medicine ball | plyometrics
Dumbbell Alternate Bicep Curl | biceps | forearms | dumbbell | strength
Squat Jerk | quadriceps | calves,glutes,hamstrings,shoulders,triceps | barbell | strength
Smith Machine Upright Row | traps | biceps,middle back,shoulders | machine | strength
Anterior Tibialis-SMR | calves |  | other | stretching
Dumbbell Scaption | shoulders | traps | dumbbell | strength
Standing Dumbbell Calf Raise | calves |  | dumbbell | strength
Linear Acceleration Wall Drill | hamstrings | calves,glutes,quadriceps | None | plyometrics
3/4 Sit-Up | abdominals |  | body only | strength
Sled Reverse Flye | shoulders |  | other | strength
One-Arm Incline Lateral Raise | shoulders |  | dumbbell | strength
Inverted Row | middle back | lats | None | strength
90/90 Hamstring | hamstrings | calves | body only | stretching
Kettlebell Seesaw Press | shoulders | triceps | kettlebells | strength
Air Bike | abdominals |  | body only | strength
Hip Lift with Band | glutes | calves,hamstrings | bands | powerlifting
Cocoons | abdominals |  | body only | strength
Standing Biceps Cable Curl | biceps |  | cable | strength
Yoke Walk | quadriceps | abdominals,abductors,adductors,calves,glutes,hamstrings,lower back | other | strongman
Skating | quadriceps | abductors,adductors,calves,glutes,hamstrings | other | cardio
Quad Stretch | quadriceps |  | other | stretching
Middle Back Shrug | middle back |  | dumbbell | strength
Dumbbell Seated Box Jump | quadriceps | calves,glutes,hamstrings | dumbbell | plyometrics
Barbell Seated Calf Raise | calves |  | barbell | strength
Lying Close-Grip Barbell Triceps Extension Behind The Head | triceps |  | barbell | strength
Side Jackknife | abdominals |  | body only | strength
Suspended Split Squat | quadriceps | abductors,adductors,calves,glutes,hamstrings | other | strength
Advanced Kettlebell Windmill | abdominals | glutes,hamstrings,shoulders | kettlebells | strength
Standing Hamstring and Calf Stretch | hamstrings |  | other | stretching
Cable Hammer Curls - Rope Attachment | biceps |  | cable | strength
Push Press - Behind the Neck | shoulders | calves,quadriceps,triceps | barbell | olympic weightlifting
Lying Cable Curl | biceps |  | cable | strength
Side to Side Box Shuffle | quadriceps | abductors,adductors,calves,hamstrings | other | plyometrics
One Arm Against Wall | lats |  | None | stretching
Butterfly | chest |  | machine | strength
Foot-SMR | calves |  | other | stretching
Alternating Kettlebell Press | shoulders | triceps | kettlebells | strength
Child's Pose | lower back | glutes,middle back | None | stretching
Standing Cable Chest Press | chest | shoulders,triceps | cable | strength
Plyo Kettlebell Pushups | chest | shoulders,triceps | kettlebells | strength
Good Morning | hamstrings | abdominals,glutes,lower back | barbell | powerlifting
Barbell Glute Bridge | glutes | calves,hamstrings | barbell | powerlifting
Wide-Grip Decline Barbell Bench Press | chest | shoulders,triceps | barbell | strength
Ab Roller | abdominals | shoulders | other | strength
Scapular Pull-Up | traps | lats,middle back | None | strength
One-Arm Overhead Kettlebell Squats | quadriceps | calves,glutes,hamstrings,shoulders | kettlebells | strength
Lying Close-Grip Barbell Triceps Press To Chin | triceps |  | e-z curl bar | strength
Snatch Pull | hamstrings | calves,glutes,lower back,quadriceps,traps | barbell | strength
Chain Press | chest | shoulders,triceps | other | powerlifting
Wide-Grip Decline Barbell Pullover | chest | shoulders,triceps | barbell | strength
Hurdle Hops | hamstrings | abductors,adductors,calves,glutes,hamstrings | other | plyometrics
Body-Up | triceps | abdominals,forearms | body only | strength
Squat with Plate Movers | quadriceps | abductors,adductors,calves,glutes,hamstrings | barbell | strength
Leg Extensions | quadriceps |  | machine | strength
World's Greatest Stretch | hamstrings | calves,glutes,quadriceps | None | stretching
Close-Grip Front Lat Pulldown | lats | biceps,middle back,shoulders | cable | strength
Reverse Hyperextension | hamstrings | calves,glutes | machine | strength
Dumbbell Incline Shoulder Raise | shoulders | triceps | dumbbell | strength
Pelvic Tilt Into Bridge | lower back |  | None | stretching
Close-Grip Dumbbell Press | triceps | chest,shoulders | dumbbell | strength
Moving Claw Series | hamstrings | calves,quadriceps | None | plyometrics
Standing Concentration Curl | biceps | forearms | dumbbell | strength
Extended Range One-Arm Kettlebell Floor Press | chest | shoulders,triceps | kettlebells | strength
Rocket Jump | quadriceps | calves,hamstrings | body only | plyometrics
Bench Press - With Bands | chest | shoulders,triceps | bands | strength
Low Pulley Row To Neck | shoulders | biceps,middle back,traps | cable | strength
Incline Bench Pull | middle back | lats,shoulders | barbell | strength
Palms-Down Dumbbell Wrist Curl Over A Bench | forearms |  | dumbbell | strength
Reverse Grip Bent-Over Rows | middle back | biceps,lats,shoulders | barbell | strength
Incline Push-Up Reverse Grip | chest | abdominals,shoulders,triceps | body only | strength
Crucifix | shoulders | forearms | other | strongman
Trail Running/Walking | quadriceps | calves,glutes,hamstrings | None | cardio
Standing Hip Circles | abductors | adductors | body only | stretching
Step-up with Knee Raise | glutes | hamstrings,quadriceps | body only | strength
Bodyweight Squat | quadriceps | glutes,hamstrings | body only | strength
Seated Dumbbell Palms-Down Wrist Curl | forearms |  | dumbbell | strength
One-Arm Dumbbell Row | middle back | biceps,lats,shoulders | dumbbell | strength
Machine Triceps Extension | triceps |  | machine | strength
Barbell Squat To A Bench | quadriceps | calves,glutes,hamstrings,lower back | barbell | strength
Elbow to Knee | abdominals |  | body only | strength
Standing Dumbbell Upright Row | traps | biceps,shoulders | dumbbell | strength
Dynamic Back Stretch | lats |  | None | stretching
Incline Dumbbell Curl | biceps |  | dumbbell | strength
Standing One-Arm Dumbbell Triceps Extension | triceps | chest,shoulders | dumbbell | strength
Straight Raises on Incline Bench | shoulders | traps | barbell | strength
The Straddle | hamstrings | adductors,calves | None | stretching
Dumbbell Incline Row | middle back | biceps,forearms,lats,shoulders | dumbbell | strength
Clean Pull | quadriceps | forearms,glutes,hamstrings,lower back,traps | barbell | olympic weightlifting
Single-Arm Push-Up | chest | shoulders,triceps | body only | strength
Lying One-Arm Lateral Raise | shoulders |  | dumbbell | strength
Incline Dumbbell Flyes | chest | shoulders | dumbbell | strength
Leg-Over Floor Press | chest | shoulders,triceps | kettlebells | strength
Band Good Morning (Pull Through) | hamstrings | glutes,lower back | bands | powerlifting
Trap Bar Deadlift | quadriceps | glutes,hamstrings | other | strength
Wide Stance Stiff Legs | hamstrings | adductors,glutes,lower back | barbell | olympic weightlifting
Dumbbell Clean | hamstrings | calves,forearms,glutes,lower back,quadriceps,shoulders,traps | dumbbell | strength
Decline Close-Grip Bench To Skull Crusher | triceps | chest,shoulders | barbell | strength
Seated Dumbbell Curl | biceps |  | dumbbell | strength
Pyramid | lower back | shoulders | exercise ball | stretching
Isometric Neck Exercise - Front And Back | neck |  | body only | strength
Freehand Jump Squat | quadriceps | calves,glutes,hamstrings | body only | strength
Standing Military Press | shoulders | triceps | barbell | strength
Open Palm Kettlebell Clean | hamstrings | glutes,lower back,quadriceps,shoulders | kettlebells | strength
Standing Inner-Biceps Curl | biceps |  | dumbbell | strength
Arm Circles | shoulders | traps | None | stretching
Face Pull | shoulders | middle back | cable | strength
Seated Calf Stretch | calves | hamstrings,lower back | None | stretching
Bent-Arm Dumbbell Pullover | chest | lats,shoulders,triceps | dumbbell | strength
Front Incline Dumbbell Raise | shoulders |  | dumbbell | strength
Behind Head Chest Stretch | chest | shoulders | other | stretching
Medicine Ball Scoop Throw | shoulders | abdominals,hamstrings,quadriceps | medicine ball | plyometrics
Hack Squat | quadriceps | calves,glutes,hamstrings | machine | strength
Power Clean | hamstrings | calves,forearms,glutes,lower back,middle back,quadriceps,shoulders,traps,triceps | barbell | strength
Jerk Dip Squat | quadriceps | abdominals,calves | barbell | olympic weightlifting
Clean from Blocks | quadriceps | calves,glutes,hamstrings,shoulders,traps | barbell | olympic weightlifting
Dumbbell Tricep Extension -Pronated Grip | triceps |  | dumbbell | strength
Flutter Kicks | glutes | hamstrings | body only | strength
Seated Front Deltoid | shoulders | chest | body only | stretching
Kipping Muscle Up | lats | abdominals,biceps,forearms,middle back,shoulders,traps,triceps | other | strength
Crossover Reverse Lunge | lower back | abdominals,abductors,glutes,hamstrings,quadriceps | None | stretching
Calf Stretch Elbows Against Wall | calves |  | None | stretching
Bodyweight Walking Lunge | quadriceps | calves,glutes,hamstrings | None | strength
Butt Lift (Bridge) | glutes | hamstrings | body only | strength
Machine Bench Press | chest | shoulders,triceps | machine | strength
Seated Bent-Over Two-Arm Dumbbell Triceps Extension | triceps |  | dumbbell | strength
Barbell Curls Lying Against An Incline | biceps |  | barbell | strength
Hug A Ball | lower back | calves,glutes | exercise ball | stretching
Elevated Back Lunge | quadriceps | glutes,hamstrings | barbell | strength
Dumbbell Flyes | chest |  | dumbbell | strength
Front Raise And Pullover | chest | lats,shoulders,triceps | barbell | strength
Chain Handle Extension | triceps |  | other | powerlifting
Lying Machine Squat | quadriceps | calves,glutes,hamstrings | machine | strength
Sled Overhead Triceps Extension | triceps |  | other | strength
Barbell Guillotine Bench Press | chest | shoulders,triceps | barbell | strength
Cable Wrist Curl | forearms |  | cable | strength
Seated Cable Shoulder Press | shoulders | triceps | cable | strength
Decline Crunch | abdominals |  | body only | strength
Back Flyes - With Bands | shoulders | middle back,triceps | bands | strength
Split Snatch | hamstrings | calves,forearms,glutes,hamstrings,lower back,quadriceps,shoulders,traps,triceps | barbell | olympic weightlifting
Calf Raises - With Bands | calves |  | bands | strength
Box Jump (Multiple Response) | hamstrings | abductors,adductors,calves,glutes,quadriceps | other | plyometrics
Bicycling | quadriceps | calves,glutes,hamstrings | other | cardio
Seated Palms-Down Barbell Wrist Curl | forearms |  | barbell | strength
Arnold Dumbbell Press | shoulders | triceps | dumbbell | strength
Cross Body Hammer Curl | biceps | forearms | dumbbell | strength
Dumbbell Lunges | quadriceps | calves,glutes,hamstrings | dumbbell | strength
Bent Over Barbell Row | middle back | biceps,lats,shoulders | barbell | strength
Bent Over Two-Arm Long Bar Row | middle back | biceps,lats | barbell | strength
Split Clean | quadriceps | calves,forearms,glutes,hamstrings,lower back,shoulders,traps | barbell | olympic weightlifting
Close-Grip EZ-Bar Curl with Band | biceps | forearms | e-z curl bar | strength
Seated Barbell Military Press | shoulders | triceps | barbell | strength
Chair Squat | quadriceps | calves,glutes,hamstrings | machine | strength
Cable Lying Triceps Extension | triceps |  | cable | strength
Barbell Curl | biceps | forearms | barbell | strength
Seated Flat Bench Leg Pull-In | abdominals |  | body only | strength
Runner's Stretch | hamstrings | calves | None | stretching
Leverage Incline Chest Press | chest | shoulders,triceps | machine | strength
Bent-Arm Barbell Pullover | lats | chest,lats,shoulders,triceps | barbell | strength
Groin and Back Stretch | adductors |  | None | stretching
Incline Push-Up Depth Jump | chest | shoulders,triceps | other | plyometrics
Clean | hamstrings | calves,forearms,glutes,lower back,quadriceps,shoulders,traps | barbell | olympic weightlifting
Bent Over One-Arm Long Bar Row | middle back | biceps,lats,lower back,traps | barbell | strength
Side Wrist Pull | shoulders | forearms,lats | None | stretching
Barbell Hip Thrust | glutes | calves,hamstrings | barbell | powerlifting
Kneeling Jump Squat | glutes | calves,hamstrings,quadriceps | barbell | olympic weightlifting
Cable Chest Press | chest | shoulders,triceps | cable | strength
Bottoms-Up Clean From The Hang Position | forearms | biceps,shoulders | kettlebells | strength
Landmine 180's | abdominals | glutes,lower back,shoulders | barbell | strength
Thigh Abductor | abductors | glutes | machine | strength
Rhomboids-SMR | middle back | traps | foam roll | stretching
Flat Bench Leg Pull-In | abdominals |  | body only | strength
Bench Press - Powerlifting | triceps | chest,forearms,lats,shoulders | barbell | powerlifting
One Arm Dumbbell Preacher Curl | biceps |  | dumbbell | strength
See-Saw Press (Alternating Side Press) | shoulders | abdominals,triceps | dumbbell | strength
Elevated Cable Rows | lats | middle back,traps | cable | strength
Alternate Hammer Curl | biceps | forearms | dumbbell | strength
Two-Arm Kettlebell Row | middle back | biceps,lats | kettlebells | strength
Bradford/Rocky Presses | shoulders | triceps | barbell | strength
Sit Squats | quadriceps | abductors,glutes,hamstrings | None | stretching
Hanging Leg Raise | abdominals |  | body only | strength
Barbell Step Ups | quadriceps | calves,glutes,hamstrings,quadriceps | barbell | strength
Machine Bicep Curl | biceps |  | machine | strength
One-Arm Kettlebell Clean | hamstrings | glutes,lower back,shoulders,traps | kettlebells | strength
Incline Push-Up | chest | shoulders,triceps | body only | strength
Scissor Kick | abdominals |  | body only | stretching
Smith Machine Hang Power Clean | hamstrings | glutes,lower back,quadriceps,shoulders,traps | machine | strength
Standing Low-Pulley Deltoid Raise | shoulders | forearms | cable | strength
Triceps Pushdown - V-Bar Attachment | triceps |  | cable | strength
Ring Dips | triceps | chest,shoulders | other | strength
Seated Hamstring | hamstrings | calves | None | stretching
Wide-Grip Rear Pull-Up | lats | biceps,middle back,shoulders | body only | strength
Seated Close-Grip Concentration Barbell Curl | biceps |  | barbell | strength
Smith Machine Decline Press | chest | shoulders,triceps | machine | strength
Standing Pelvic Tilt | lower back | glutes | None | stretching
Jerk Balance | shoulders | glutes,hamstrings,quadriceps,triceps | barbell | olympic weightlifting
Overhead Lat | lats | triceps | other | stretching
Prowler Sprint | hamstrings | calves,chest,glutes,quadriceps,shoulders | other | cardio
Side-Lying Floor Stretch | lats |  | None | stretching
Incline Dumbbell Press | chest | shoulders,triceps | dumbbell | strength
Box Skip | hamstrings | abductors,adductors,calves,glutes,quadriceps | other | plyometrics
Side Hop-Sprint | quadriceps | abductors,adductors,calves,hamstrings | other | plyometrics
Reverse Flyes With External Rotation | shoulders |  | dumbbell | strength
